NO ./textures/north.png
SO ./textures/south.png
WE ./textures/west.png
EA ./textures/east.png

F 220, 100,240
C 255, 0,0

11111111
111111111111
111101111111
11111111111100001
100011E00011
11111101111
11111111111
