NO ./textures/north.png
SO ./textures/south.png
WE ./textures/west.png
EA ./textures/east.png

F 220,100,240
C 225,30,255

111111111
11100N1
111011   
100   
101
10000000000000000000000000000000000000000000000000001
11000001
111111111111111
