NO ./textures/north.png
SO ./textures/south.png
WE ./textures/west.png
EA ./textures/east.png

C 225,30,255
F 220,100,255

        111111111111111111111111
        100100000011000010000001
        1011000001110000000000001
        1001000000000000000000001
111111111011000001110000000000001
100000000011000001110111111111111
11110111111111011100000010001
11110111111111011101010010001
11000000110101011100000010001
10000000000000001100000010001
10000000000000011010100010N01
110000011101010111110111100111
11110111 1110101 101111010001
11111111 1111111 11111111111