NO ./textures/north.png
SO ./textures/south.png
WE ./textures/west.png
EA ./textures/east.png

F 220,100,240
C 255,0,0





11111111111
10000000N001

1111111111111111




