NO ./textures/north.png
SO ./textures/south.png
EA ./textures/east.png
WE ./textures/west.png

C ./textures/ceiling.png
F ./textures/floor.png

1111111111111
10000000000N1
1111111111111
