NO ./textures/north.png
SO ./textures/south.png
EA ./textures/east.png
WE ./textures/west.png

F ./textures/floor.png
C ./textures/ceiling.png

        1111111111111111111111111
        1001000000110000100000001
        1011000001110000000000001
        1001000000100000000000001
111111111011000001110000000000001
10000000001100000111011111111111100001
11110111111111011100000010001
11110111111111011101010010001
11000000110101011100000010001
10000000000000000100000010001
10000000000000011010100010N01
110000011101010111110111100111
11110111 1110101 101111010001
11111111 1111111 11111111111
