NO ./textures/north.png
SO ./textures/south.png
EA ./textures/east.png
WE ./textures/west.png

C ./textures/ceiling.png
F ./textures/floor.png

11111
10000000N001
1111111111111111
