NO ./textures/north.png
SO ./textures/south.png
WE ./textures/west.png
EA ./textures/east.png

F 150,100,150
C 255,0,255

11111111
111111111111
111101111111
111111111111
111111E0000001
11111101111
11111111111